# MAP INFO : row	column	TileRow	TileColumn	TileWidth
[INFO]
12	30	5	11	16	16	6
[ROWS]
1	1	1	1	1	1	1	1	1	1	1	2	3	3	3	3	3	3	3	3	3	3	3	3	3	3	3	3	3	3
4	4	4	4	4	4	4	4	4	4	4	2	3	3	3	3	3	3	3	3	3	3	3	3	3	3	3	3	3	3
4	4	4	4	4	4	4	4	4	4	4	2	3	3	3	3	3	3	3	3	3	3	3	3	3	3	3	3	3	3
4	4	5	6	7	4	4	4	4	4	4	2	3	3	3	3	3	3	3	3	3	3	3	3	3	3	3	3	3	3
4	4	8	9	10	4	4	4	4	4	4	2	3	3	3	3	3	3	3	3	3	3	3	3	3	3	3	3	3	3
4	4	4	4	4	4	4	4	4	4	4	2	3	3	3	3	3	11	12	3	3	3	3	3	3	3	3	3	3	3
4	4	4	4	4	4	4	4	4	4	4	2	3	3	3	3	3	16	17	3	3	3	3	3	3	3	3	3	3	3
4	4	4	4	4	4	4	4	4	4	4	2	3	3	3	3	3	21	22	12	3	3	3	3	3	3	3	3	3	3
4	4	4	26	27	4	4	28	29	4	4	2	3	3	3	3	3	21	30	17	3	3	3	3	3	3	3	3	11	12
4	4	4	31	32	27	4	33	34	4	4	2	3	3	3	3	3	21	3	22	12	3	3	3	3	3	3	3	16	17
35	35	26	36	37	38	4	39	40	4	4	2	3	3	3	3	11	41	3	30	17	3	3	3	3	3	3	11	41	42
43	43	44	45	46	47	48	49	50	48	48	51	51	51	51	51	52	53	51	51	54	51	51	51	51	51	51	52	53	54
         