[INFO]
10	14	4	10	16
[ROWS]
11	11	11	23	8	9	8	24	8	25	8	9	11	11
14	11	11	7	11	11	11	7	39	39	39	7	11	11
8	21	8	30	11	11	11	10	8	26	8	15	11	11
11	11	11	16	11	11	11	7	11	11	11	11	11	11
11	11	11	10	8	2	8	22	11	11	34	32	33	11
11	39	39	7	39	11	11	11	34	32	36	0	31	11
39	39	38	10	38	15	8	9	35	9	8	1	31	11
39	38	38	7	38	38	39	7	31	39	39	39	31	11
39	38	38	27	8	9	8	28	37	32	32	32	36	11
39	39	39	39	39	39	39	39	39	39	39	39	39	39
