[INFO]
10	14	4	10	16
[ROWS]
10	10	10	22	7	8	7	23	7	24	7	8	10	10
13	10	10	6	10	10	10	6	38	38	38	6	10	10
7	20	7	29	10	10	10	9	7	25	7	14	10	10
10	10	10	15	10	10	10	6	10	10	10	10	10	10
10	10	10	9	7	2	7	21	10	10	33	31	32	10
10	38	38	6	38	10	10	10	33	31	35	0	30	10
38	38	37	9	37	14	7	8	34	8	7	1	30	10
38	37	37	6	37	37	38	6	30	38	38	38	30	10
38	37	37	26	7	8	7	27	36	31	31	31	35	10
38	38	38	38	38	38	38	38	38	38	38	38	38	38
