# MAP INFO: 0.number of MapRows 1.number of MapColumns	2.number of TileRows	3.Number of TileColumns	4.Tile Width 5.Tile Height  6. Grid Cell Size
[INFO]
27	63	5	11	16	16	10
[ROWS]
1	1	1	1	1	1	1	1	1	1	1	1	1	1	1	1	1	1	1	1	1	1	1	1	1	1	1	1	1	1	1	1	1	1	1	1	1	1	1	1	1	1	1	1	1	1	1	1	1	1	1	1	1	1	1	1	1	1	1	1	1	1	1
1	1	1	1	1	1	1	1	1	1	1	1	1	1	1	1	1	1	1	1	1	1	1	1	1	1	1	1	1	1	1	1	1	1	1	1	1	1	1	1	1	1	1	1	1	1	1	1	1	1	1	1	1	1	1	1	1	1	1	1	1	1	1
1	1	1	1	1	1	1	1	1	1	1	1	1	1	1	1	1	1	1	1	1	1	1	1	1	1	1	1	1	1	1	1	1	1	1	2	1	1	1	1	1	1	1	1	1	1	1	1	1	1	1	1	1	1	1	1	1	1	1	1	1	1	1
1	1	1	1	1	1	1	1	1	1	1	1	1	1	1	1	1	1	1	1	1	1	1	1	1	1	1	1	1	1	1	1	1	1	3	4	5	1	1	1	1	1	1	1	1	1	1	1	1	1	1	1	1	1	1	1	1	1	1	1	1	1	1
1	1	1	1	1	1	1	1	1	1	1	1	1	1	1	1	1	1	1	1	1	1	1	1	1	1	1	1	1	1	1	1	1	6	7	7	8	9	1	1	1	1	1	1	1	1	1	1	1	1	1	1	1	1	1	1	1	1	1	1	1	1	1
1	1	1	1	1	1	1	1	1	1	1	1	1	1	1	1	1	1	1	1	1	1	1	1	1	1	1	1	1	1	1	10	3	7	7	7	7	4	5	1	1	1	2	1	1	1	1	1	1	1	1	1	1	1	1	1	1	1	1	1	1	1	1
1	1	1	1	1	1	1	1	1	1	1	1	1	1	1	1	1	1	1	1	1	1	1	1	1	1	1	1	1	1	10	11	7	7	7	7	7	7	8	9	1	3	4	5	1	1	1	1	1	1	1	1	1	1	1	1	1	1	1	1	1	1	1
1	1	1	1	1	1	1	1	1	1	1	1	1	1	1	1	1	1	1	1	1	1	1	1	1	1	1	1	1	12	13	7	7	7	7	7	7	7	7	8	14	7	7	8	9	1	1	1	1	1	1	1	1	1	1	1	1	1	1	1	1	1	1
1	1	1	1	1	1	1	1	1	1	1	1	1	1	1	1	1	1	1	1	1	1	1	1	1	1	1	1	15	16	7	7	7	7	7	7	7	7	7	17	17	17	7	7	4	5	1	1	1	1	1	1	1	1	1	1	1	1	1	1	1	1	1
1	1	1	1	1	1	1	1	1	1	1	1	1	1	1	1	1	1	1	1	1	1	1	1	1	1	1	18	19	7	7	7	7	7	7	7	7	7	17	17	7	17	17	7	7	8	9	1	1	1	1	1	1	1	1	1	1	1	1	1	1	1	1
1	1	1	1	1	1	1	1	1	1	1	1	1	1	1	1	1	1	1	1	1	1	1	1	1	1	18	20	7	7	7	7	7	7	7	7	7	17	17	7	21	7	17	17	7	7	8	22	1	1	1	1	1	1	1	1	1	1	1	1	1	1	1
1	1	1	1	1	1	1	1	1	1	1	1	1	1	1	1	1	1	1	1	1	1	1	1	1	23	24	7	7	7	7	7	7	7	7	7	7	17	7	7	25	7	7	17	7	7	26	27	1	1	1	1	1	1	1	1	1	1	1	1	1	1	1
1	1	1	1	1	1	1	1	1	1	1	1	1	1	1	1	1	1	1	1	1	1	1	1	1	28	29	7	7	7	7	7	7	7	7	7	7	17	17	7	7	7	17	17	7	7	30	1	1	1	1	1	1	1	1	1	1	1	1	1	1	1	1
1	1	1	1	1	1	1	1	1	1	1	1	1	1	1	1	1	1	1	1	1	1	1	1	1	1	31	32	7	7	7	7	7	7	7	7	7	7	17	17	7	17	17	7	7	7	7	30	1	1	1	1	1	1	1	1	1	1	1	1	1	1	1
1	1	1	1	1	1	1	1	1	1	1	1	1	1	1	1	1	1	1	1	1	1	1	1	1	1	1	33	7	7	7	7	7	7	7	7	7	7	7	17	17	17	7	7	7	7	7	34	1	1	1	1	1	1	1	1	1	1	1	1	1	1	1
1	1	1	1	1	1	1	1	1	1	1	1	1	1	1	1	1	1	1	1	1	1	1	1	1	1	35	7	7	7	7	7	7	7	7	7	7	7	7	7	7	7	7	7	7	7	36	1	1	1	35	37	1	1	1	1	1	1	1	1	1	1	1
1	1	1	1	1	1	1	1	1	1	1	1	1	1	1	1	1	1	1	1	1	1	1	1	1	1	38	7	7	7	7	7	7	7	7	7	7	7	7	7	7	7	7	7	7	7	30	1	1	33	7	7	30	1	1	1	1	1	1	1	1	1	1
1	1	1	1	1	1	1	1	1	1	1	1	35	37	1	1	1	1	1	1	1	1	35	37	1	1	1	39	7	7	7	7	7	7	7	7	7	7	7	7	7	7	7	7	7	7	7	37	35	7	7	7	7	37	1	1	1	1	1	1	1	1	1
1	1	1	1	1	1	1	1	1	1	1	33	7	7	30	1	1	1	1	1	1	33	7	7	30	1	1	33	7	7	7	7	7	7	7	7	7	7	7	7	7	7	7	7	7	7	7	7	7	7	7	7	7	7	30	1	1	1	1	1	1	1	1
1	1	1	1	1	1	1	1	1	1	35	7	7	7	7	37	1	1	1	1	35	7	7	7	7	37	35	7	7	7	7	7	7	7	7	7	7	7	7	7	7	7	7	7	7	7	7	7	7	7	7	7	7	7	7	30	1	1	1	1	1	1	1
1	1	1	1	1	1	1	1	1	33	7	7	7	7	7	7	30	1	1	33	7	7	7	7	7	7	7	7	7	7	7	7	7	7	7	7	7	7	7	7	7	7	7	7	7	7	7	7	7	7	7	7	7	7	7	34	1	1	1	1	1	1	1
1	1	1	1	1	1	1	1	35	7	7	17	7	17	7	17	7	30	35	7	17	7	17	7	17	7	17	7	7	7	17	7	17	7	17	7	7	7	17	7	17	7	17	7	17	7	17	7	7	7	17	7	17	7	17	37	1	1	1	1	1	1	1
1	1	1	1	1	1	1	1	38	7	17	7	17	7	17	7	17	7	7	7	7	17	7	17	7	17	7	7	7	17	7	17	7	17	7	17	7	7	7	17	7	17	7	17	7	17	7	7	7	17	7	17	7	17	40	41	30	1	1	1	1	1	1
1	1	1	1	1	1	1	1	1	39	7	7	7	7	7	7	7	7	7	7	7	7	7	7	7	7	7	7	7	7	7	7	7	7	7	7	7	7	7	7	7	7	7	7	7	7	7	7	7	7	7	7	7	7	42	43	7	30	1	1	1	1	1
1	1	1	1	1	1	44	1	1	35	7	7	7	7	7	7	7	7	7	7	7	7	7	7	7	7	7	7	7	7	7	7	7	7	7	7	7	7	7	7	7	7	7	7	7	7	7	7	7	7	7	7	7	7	45	46	7	34	1	1	1	1	1
47	47	47	47	47	47	47	47	47	48	49	49	49	49	49	49	49	49	49	49	49	49	49	49	49	49	49	49	49	49	49	49	49	49	49	49	49	49	49	49	49	49	49	49	49	49	49	49	49	49	49	49	49	49	45	46	50	47	47	47	47	47	47
51	51	51	51	51	51	51	51	51	51	51	51	51	51	51	51	51	51	51	51	51	51	51	51	51	51	51	51	51	51	51	51	51	51	51	51	51	51	51	51	51	51	51	51	51	51	51	51	51	51	51	51	51	51	45	46	51	51	51	51	51	51	51
        